████████████E█
█          █ █
█ ██████████ █
█ █          █
█ █ ████████ █
█          ███
█ ████████ █ █
███      █ █ █
███ ██ ███   █
█          █ █
████████████X█